..........................
..........................
..BB..BB..BB..BB..BB..BB..
..BB..BB..BB..BB..BB..BB..
..BB..BB..BB..BB..BB..BB..
..BB..BB..BBSSBB..BB..BB..
..BB..BB..BBSSBB..BB..BB..
..BB..BB..BB..BB..BB..BB..
..BB..BB..........BB..BB..
..BB..BB..........BB..BB..
..........BB..BB..........
..........BB..BB..........
BB..BBBB..........BBBB..BB
SS..BBBB..........BBBB..SS
..........BB..BB..........
..........BBBBBB..........
..BB..BB..BBBBBB..BB..BB..
..BB..BB..BB..BB..BB..BB..
..BB..BB..BB..BB..BB..BB..
..BB..BB..BB..BB..BB..BB..
..BB..BB..........BB..BB..
..BB..BB..........BB..BB..
..BB..BB..........BB..BB..
..BB..BB...BBBB...BB..BB..
...........B..B...........
...........B..B...........
11000